;Timwi's Levels

;1
#####            #####
#   ##############  @#
#     $ #   $   $ $  #
# $$#     $   $   $  #
##  ###############$##
 #$   $.*.$   $  $  #
 #  #   #..$$$ $ # $#
 ## #####...   $ #  #
 # ..#  #....  $ #$ #
 # ..#  #.....   #  #
###. #  #......$## $##
# ## ##########  $   #
# #              $   #
#   ##############  ##
#####            #####

;2
#####
#@$.#
#####
